tempInf x	Seuil inférieur à x de température atteint
tempSup x	Seuil supérieur à x de température atteint
porteOuv	Porte ouverte
porteFer	Porte fermée
vampire	Présence vampire
meduse	Présence méduse
intrus	Présence intrus
sirene	Présence sirène
invite	Présence invité
fenOuv	Fenêtre ouverte
fenFer	Fenêtre fermée
humInf x 	Seuil inférieur d'humidité x atteint
humSup x	Seuil supérieur à x d'humidité atteint
pasChange x	Pas de changement depuis x temps ?
mouv	Détection mouvement
lumEt	Lumière éteinte ?
lumAll	Lumière allumée ?
pasBouge x	Pas de mouvement depuis x temps
dansCuisine	Dans cuisine
dansChambre	Dans chambre
dansSalon	Dans salon
dansCouloir	Dans couloir
dansPiece x 	Dans pièce x
climAll	Climatisation allumée
climEt	Climatisation éteinte
incAll	Système anti-incendie allumé
incEt	Système anti-incendie éteint